10
#####  
#@ $ .#
#     #
#     #
#####  
