1 200 300
#############
#+      #   #
#       # $  #
#       #    #
#       *    #
#       # $. #
##############
