10
######  
#@ $ .#
#     #
#     #
###### 
